10 10
       ***
 ** ** ***
 ** **   /
 ** ** ***
    ** ***
*** ******
*** ******
***      /
*** ******
/   ******
**********
