10 10
 *   *****
 * *      
 * * ***  
 * *****  
   *   *  
** * *  * 
 * * * *  
  *  * ***
**** *   *
     */***