10 10
 * * *****
 *      **
 * * **  *
 * * *** *
   *    **
** * *  * 
 * * * *  
     * ***
* ** * ***
     */***