11 11
*  ******  
  *      * 
*** ***  * 
* *  **  * 
*  *  *  * 
******  * *
* *       *
    * *****
* **    ***
* *    *  *
*/***/*****