11 11
*  ******  
  *      * 
* * ***  * 
* *  **  * 
*  *  *  * 
******  * *
* *  *  *  
    * **** 
* ** *  ** 
* *  * *  /
*/*********