09 09
 ********
 ********
 ********
 ********
         
** ** ** 
** **  */
** ***  *
**/******