11 11
 * * ******
 *        *
 * * *** **
 * *****  *
  **   *  *
* ** *  * *
*    * *  /
* *  * * **
* **  *  **
/    **   *
***********